22 12
WWWWWWWWWWWWWWWWWWWWWW
WH.W...W.W.W....W....W
WW.W.W.W.W....W...W..W
WW...W.W.W.WWWWWWWW..W
WWWWWW.W.W.W.W.....WWW
W......W.W.W.W.WWWW..W
W.WWWW...W.W.W.W...W.W
W..W.W.W.W.W.W.W.WWWWW
WWWW.W...W.W.....W...W
WW...W.....W.WWW.W...W
W..W.....W.MMMMW...WXW
WWWWWWWWWWWWWWWWWWWWWW
